REB = "setup/countries/rebels.txt"
PIR = "setup/countries/pirates.txt"
BAR = "setup/countries/barbarians.txt"
MER = "setup/countries/mercenaries.txt"

#HIT
#Europe
HRE = "setup/countries/europe/hre.txt"
AQT = "setup/countries/europe/Aquitaine.txt"
BRZ = "setup/countries/europe/Bretagne.txt"
BSQ = "setup/countries/europe/Vasconia.txt"
BRG = "setup/countries/europe/Burgundy.txt"
PRO = "setup/countries/europe/Provence.txt"
GTL = "setup/countries/europe/Gothalaunia.txt"
TAR = "setup/countries/europe/Tarragona.txt"
ISP = "setup/countries/europe/Ispannia.txt"
AST = "setup/countries/europe/Asturia.txt"
UAD = "setup/countries/europe/Uandils.txt"
BYZ = "setup/countries/europe/Byzantium.txt"
PAP = "setup/countries/europe/Papal States.txt"
RCR = "setup/countries/europe/Red Croatia.txt"
ALB = "setup/countries/europe/Albania.txt"
HUN = "setup/countries/europe/Hungary.txt"
RUG = "setup/countries/europe/Rughan.txt"
PTZ = "setup/countries/europe/Patzinakia.txt"
KUN = "setup/countries/europe/Kunsag.txt"
SZE = "setup/countries/europe/Szekely.txt"
IST = "setup/countries/europe/Istria.txt"
MOE = "setup/countries/europe/Moesogoths.txt"
PHR = "setup/countries/europe/Phrygia.txt"
TRB = "setup/countries/europe/Trebizond.txt"
CMG = "setup/countries/europe/Commagene.txt"
BYT = "setup/countries/europe/Bythinia.txt"
MYS = "setup/countries/europe/Mysia.txt"
LYD = "setup/countries/europe/Lydia.txt"
KMT = "setup/countries/europe/Khemet.txt"
GHS = "setup/countries/europe/Ghassanids.txt"
JUD = "setup/countries/europe/Judea.txt"
PHO = "setup/countries/europe/Phoenicia.txt"
TJZ = "setup/countries/europe/Tell Jezer.txt"
BEJ = "setup/countries/europe/Bejas.txt"
MAK = "setup/countries/europe/Makuria.txt"
ALO = "setup/countries/europe/Alodia.txt"
AKS = "setup/countries/europe/Aksum.txt"
AFR = "setup/countries/europe/Afar.txt"
ADL = "setup/countries/europe/Adal.txt"
CLP = "setup/countries/europe/Caliphate.txt"
HIM = "setup/countries/europe/Himyar.txt"
TWL = "setup/countries/europe/Tawilid.txt"
OMN = "setup/countries/europe/Oman.txt"
KZH = "setup/countries/europe/Kizilhanid.txt"
SYA = "setup/countries/europe/Syria.txt"
OSR = "setup/countries/europe/Osroene.txt"
AZN = "setup/countries/europe/Arzanene.txt"
BNV = "setup/countries/europe/Beneviento.txt"
ATR = "setup/countries/europe/Aterno.txt"
ANC = "setup/countries/europe/Ancona.txt"
SIE = "setup/countries/europe/Siena.txt"
FLO = "setup/countries/europe/Florence.txt"
PIS = "setup/countries/europe/Pisa.txt"
VLT = "setup/countries/europe/Volterra.txt"
PST = "setup/countries/europe/Pistoia.txt"
LUC = "setup/countries/europe/Lucca.txt"
LAR = "setup/countries/europe/Lesser Armenia.txt"
PAR = "setup/countries/europe/Parthia.txt"
ALK = "setup/countries/europe/Aluank.txt"
KSA = "setup/countries/europe/Serbs-Avars.txt"
POL = "setup/countries/europe/Poland.txt"
ZAO = "setup/countries/europe/Zaodra.txt"
#Asia